.
.
.
.
.
..........#
.........##
.@......###
###########
###########